Questa voce elenca motti nazionali. I motti nazionali possono comparire sullo stemma o emblema nazionale dello Stato, su monete o banconote. Non tutti gli stati hanno un motto.


== A ==
 Albania: Feja e Shqiptarit është Shqiptaria (albanese, La Religione degli Albanesi è l'Albanesimo) e Ti, Shqipëri, më jep nder, më jep emrin Shqiptar (Tu Albania mi dai onore, mi dai il nome di Albanese).
 Algeria: بالشعب و للشعب Bil-shaʿb wa lil-shaʿb (arabo, Dal popolo e per il popolo)
 Alto Volta: Unité, Travail, Justice (francese, Unità, Lavoro, Giustizia)
 Andorra: Virtus, Unita, Fortior (latino, La virtù unita è più forte)
 Angola: Virtus, Unita, Fortior (latino, La virtù unita è più forte)
 Anguilla: Strength and Endurance (inglese, Forza e Tenacia)
 Antigua e Barbuda: Each endeavouring, all achieving (inglese, Ciascuno si impegna, tutti conseguono)
 Arabia Saudita: لا إله إلا الله محمد رسول الله (Lā ʾilāha illā l-Lāh; Muḥammadu r-rasūlu l-Lāh) (arabo Non c'è altro Dio al di fuori di Allah e Maometto è il suo profeta)
 Argentina: En Unión y Libertad (spagnolo, In Unione e Libertà)
 Armenia: Մեկ Ազգ, Մեկ Մշակույթ Mek Azg, Mek Mshakouyt (armeno, Una Nazione, Una Cultura)
 Aruba: Semper progrediens (latino, Sempre procedendo)
 Australia: nessuno, in passato Advance Australia (inglese, Avanza Australia)
 Austria: in passato AEIOU, con il significato di Austriae est imperare orbi universo (latino, All'Austria spetta governare su tutto il mondo)
 Austria-Ungheria: Indivisibiliter ac Inseparabiliter (latino, Indivisibilmente e Inseparabilmente)

 Azerbaigian: Odlar Yurdu (azero, Paese dei fuochi), in passato Bir kərə yüksələn bayraq, bir daha enməz! (La bandiera una volta alzata non cadrà mai!)
 Azzorre: Antes morrer livres que em paz sujeitos (portoghese, Piuttosto morire come uomini liberi che essere schiavizzati in pace)


== B ==
 Bahamas: Forward, Upward, Onward Together (inglese, Avanti, in alto, diritto insieme)

 Bangladesh: Nazionalismo, secolarismo, socialismo e democrazia
 Barbados: Pride and Industry (inglese, Orgoglio e Industria)
 Baviera: in passato, In treue fest (tedesco, Nella lealtà incrollabile)
 Belgio: Eendracht maakt macht, L'union fait la force e Einigkeit gibt Stärke (olandese, francese e tedesco, L'unione fa la forza)
 Belize: Sub umbra floreo (latino, All'ombra fiorisco)
 Benin: Fraternité, Justice, Travail (francese, Fraternità, Giustizia, Lavoro)
 Bermuda: "Quo fata ferunt" (latino, Dove ci portano i fati)
 Bolivia: La Unión es la Fuerza (spagnolo, L'Unione è la Forza)

 Botswana: Pula (tswana, Pioggia)

 Brasile: Ordem e progresso (portoghese, Ordine e progresso) Impero del Brasile - Independência ou Morte! (portoghese, Indipendenza o Morte!)

 Brunei: الدائمون المحسنون بالهدى (arabo, Sempre in servizio con la guida di Dio)
 Bulgaria: Съединението прави силата (bulgaro, L'unione fa la forza)
 Burkina Faso: Unité, Progrès, Justice (francese, Unità, Progresso, Giustizia)
 Burundi: Unité, Travail, Progrès (francese, Unità, Lavoro, Progresso)


== C ==
 Cambogia:  Chéat, Sasna, Preăhmôhaksât (khmer, Nazione, Religione, Re)
 Camerun: Paix - Travail - Patrie (francese, Pace, Lavoro, Patria)
 Canada: A mari usque ad mare (latino, Da mare a mare)
 Isole Canarie: Océano (spagnolo, Oceano)
' Capo Verde: Unidade, trabalho, progresso (portoghese, Unità, Lavoro, Progresso)
 Isole Cayman: He hath founded it upon the seas (inglese, È lui che l'ha fondata sui mari)
 Rep. Ceca: Pravda vítězí! (ceco, La verità vince!)
 Cecoslovacchia (1918-1993): Pravda víťazí! (slovacco), Pravda vítězí! (ceco), Veritas Vincit (latino, La verità vince!)
 Rep. Centrafricana: Unité, Dignité, Travail (francese, Unità, Dignità, Lavoro)
 Ciad: Unité, Travail, Progrès (francese, Unità, Lavoro, Progresso)
 Cile: Por la razón o la fuerza (spagnolo, Per ragione o per forza)
 Cipro: Δεν ξεχνώ και αγωνίζομαι (Den xehno ke agonizomai) (greco, Non dimentico e mi sforzo)
 Colombia: Libertad y orden (spagnolo, Libertà e ordine)
 Comore: Unité, Justice, Progrès (francese, Unità, Giustizia, Progresso)
 RD del Congo: Justice - Paix - Travail (francese, Giustizia, Pace, Lavoro)
 Rep. del Congo: Unité, Travail, Progrès (francese, Unità, Lavoro, Progresso)
 Corea del Nord: 강성대국 (强盛大國 Gangseong Daeguk) (coreano, Paese grande e prosperoso)
 Corea del Sud: 홍익인간 (弘益人間 Hongik Ingan) (coreano, Beneficia tutta l'umanità)
 Corea: 광명천지 (光明天地 Kwang myeong cheon ji) (coreano, Ci sia luce sulla Terra)
 Costa Rica: Vivan siempre el trabajo y la paz (spagnolo, Lunga vita al lavoro e alla pace)
 Costa d'Avorio: Union, Discipline, Travail (francese, Unità, Disciplina, Lavoro)
 Cuba: Patria o muerte (spagnolo, Patria o morte)


== D ==
 Danimarca: Motto della regina Margrethe II: Guds hjælp, Folkets kærlighed, Danmarks styrke (danese, L'aiuto di Dio, l'amore del popolo, la forza della Danimarca)
 Dominica: Après Bondie, C'est la Ter (patois, Dopo il Buon Dio, c'è la Terra)
 Rep. Dominicana: Dios, Patria, Libertad (spagnolo, Dio, Patria, Libertà)


== E ==
 Ecuador: Dios, patria y libertad (spagnolo, Dio, Patria e Libertà)
 El Salvador: Dios, Unión, Libertad (spagnolo, Dio, Unione, Libertà)
 Estonia: Heade üllatuste maa (estone, Positivamente sorprendente)
 Unione europea: In varietate concordia (latino Concordia nella diversità)


== F ==
 Isole Falkland: Desire the right (inglese, Desidera ciò che è giusto)
 Figi: Rerevaka na Kalou ka Doka na Tui (figiano, Temi Dio e onora la Regina)
 Filippine: Maka-Diyos, Makatao, Makakalikasan at Makabansa (tagalog, Per Dio, per il Popolo, per la Natura e per la Patria)In passato: Isang bansa, isang diwa (tagalog, Una nazione, uno spirito)

 Francia: Liberté, égalité, fraternité (francese, Libertà, uguaglianza, fraternità)
 Repubblica di Vichy: Travail, Famille, Patrie (francese: Lavoro, Famiglia, Patria)


== G ==
 Gabon: Union, Travail, Justice (francese, Unione, Lavoro, Giustizia)
 Galles: Cymru am byth (gallese, Galles per sempre)
 Gambia: Progress, Peace, Prosperity (inglese, Progresso, Pace, Prosperità)
 Georgia: ძალა ერთობაშია! (Dzala ertobashia) (georgiano, La forza è nell'unità)
 Georgia del Sud e isole Sandwich meridionali: Leo terram propriam protegat (latino, Il leone protegga la sua terra)
 Germania: Einigkeit und Recht und Freiheit (tedesco, Unità e Giustizia e Libertà)
 Germania Est: Proletarier aller Länder, vereinigt Euch! (tedesco, Lavoratori di tutto il mondo, unitevi!)
 Impero tedesco: Gott mit uns (tedesco, Dio con noi)
 Germania nazista: Ein Volk, Ein Reich, Ein Führer (tedesco, Un popolo, uno Stato, un Capo)

 Ghana: Freedom and Justice (inglese, Libertà e Giustizia)
 Giamaica: Out of many, One People (inglese, Da molti, Un popolo solo)
 Giappone: 八紘一宇 (Hakko ichiu) (giapponese, Tutto il mondo sotto un unico tetto)
 Gibilterra: Nulli Expugnabilis Hosti (latino, Inespugnabile da nessun nemico)
 Gibuti: Itixaad, Gudboonaan, Ammaan e Unité, Égalité, Paix (somalo e francese: Unità, Uguaglianza, Pace)
 Giordania: الله، الوطن، المليك (Allāh, Al-Waṭan, Al-Malīk) (arabo, Dio, Patria, Sovrano)
 Grecia: Ελευθερία ή θάνατος (Eleutheria i thanatos) (greco, Libertà o morte)
Regno di Grecia (1832-1924 e 1935–67): Ίσχύς μου ή άγάπη του λαού (Iskhis mou i ayapi tou laou) (greco, L'amore del popolo è la mia forza)

 Grenada: Ever Conscious of God We Aspire, and Advance as One People (inglese, Sempre Memori di Dio Guardiamo al Futuro e Avanziamo come Un unico Popolo)
 Guatemala: Libre Crezca Fecundo (spagnolo, Libero Crescente Fecondo)
 Guinea: Travail, Justice, Solidarité (francese, Lavoro, Giustizia, Solidarietà)
 Guinea-Bissau: Unidade, Luta, Progresso (portoghese, Unità, Lotta, Progresso)
 Guinea Equatoriale: Unidad, Paz, Justicia (spagnolo, Unità, Pace, Giustizia)
 Guyana: One People, One Nation, One Destiny (inglese, Un Popolo, Una Nazione, Un Destino)


== H ==
 Haiti: L'union fait la force (francese, L'unione fa la forza)
 Honduras: Libre, Soberana e Independiente (spagnolo, Libera, Sovrana e Indipendente)
 Hong Kong Britannico: Dieu et mon droit (francese, Dio e il mio diritto)


== I ==
 India: सत्यमेव जयते (Satyameva Jayate) (sanscrito, La verità trionfa da sola)
 Indonesia: Bhinneka Tunggal Ika (antico giavanese, Unità nella diversità)
 Inghilterra: Dieu et mon droit (francese, Dio e il mio diritto) (motto reale)
 Iran:
de facto: استقلال، آزادى، جمهورى اسلامى Esteqlāl, āzādī, jomhūrī-ye eslāmī (farsi, Indipendenza, libertà, repubblica islamica)
de jure: Allaho Akbar (arabo, Dio è grande)
prima della Rivoluzione islamica il motto era Marā dād farmūd-o khod dāvar ast (farsi, Giustizia mi chiede, chi mi giudicherà).

 Iraq: الله أكبر (Allahu Akbar) (arabo, Dio è grande)
 Irlanda: Éire go deo (gaelico: Irlanda per sempre) (non ufficiale)
Fé Mhóid Bheith Saor (gaelico: Giuriamo di essere liberi) (motto nazionale)

 Isole Marshall: Jepilpilin ke Ejukaan (marshallese, Conseguimento con la forza congiunta)
 Isole Salomone: To Lead Is To Serve (inglese, Condurre è servire)
 Italia: Dio e popolo (non ufficiale)
 Regno d'Italia: FERT
 Repubblica Sociale Italiana: Per l'onore d'Italia


== K ==
 Kenya: Harambee (swahili, Lavoriamo insieme)
 Kiribati: Te mauri, te raoi ao te tabomoa (gilbertese, Salute, pace e prosperità)


== L ==
 Laos: "ສັນຕິພາບ ເອກະລາດ ປະຊາທິປະໄຕ ເອກະພາບ ວັດທະນາຖາວອນ" (lao, Pace, indipendenza, democrazia, unità e prosperità)
 Lettonia: Tēvzemei un Brīvībai (lettone, Per la Patria e la Libertà)
 Lesotho: Khotso, Pula, Nala (sotho, Pace, Pioggia, Prosperità)
 Liberia: The love of liberty brought us here (inglese, L'amore per la libertà ci ha condotto qui)
 Liechtenstein: Für Gott, Fürst und Vaterland (tedesco, Per Dio, per il Principe e per la Patria)
 Lituania: Tautos jėga vienybėje (lituano, La forza della nazione è nell'unità)
 Lussemburgo: Mir wëlle bleiwe wat mir sinn (lussemburghese, Vogliamo rimanere quello che siamo)
 Libano: كلنا للوطن، للعلى، للعلم (arabo, Tutto per la Patria, per la gloria, per la bandiera)


== M ==
 Macedonia: Слобода или смрт! (Sloboda ili smrt!) (macedone, Libertà o morte!)
 Madagascar: Tanindrazana, Fahafahana, Fandrosoana (malgascio, Terra ancestrale, Libertà, Progresso)
 Malawi: Unity and Freedom (inglese, Unità e Libertà)
 Malesia: Bersekutu Bertambah Mutu (malay, L'unione fa la forza)
 Mali: Un peuple, un but, une foi (francese, Un popolo, un fine, una fede)
 Isola di Man: Quocunque Jeceris Stabit (latino, Starà ovunque lo getterai)
 Marocco: الله، الوطن، الملك (arabo, Dio, Patria, Re)Motto reale: إن تذصروا الڷه ݐذصر کم (arabo, Se glorifichi Dio, ti glorificherà)

 Mauritania: شرف، إخاء، عدالة o Honneur, Fraternité, Justice (arabo e francese, Onore, Fraternità, Giustizia)
 Mauritius: Stella Clavisque Maris Indici (latino, Stella e Chiave dell'Oceano Indiano)
 Micronesia: Peace, Unity, Liberty (inglese, Pace, Unità, Libertà)
 Monaco: Deo juvante (latino, Con l'aiuto di Dio)
 Montenegro: Čojstvo i junaštvo / Чојство и јунаштво (serbo, Cavalleria ed eroismo)


== N ==
 Namibia: Unity, liberty, justice (inglese, Unità, libertà, giustizia)
 Nauru: God's will first (inglese, La volontà di Dio innanzitutto)
 Nepal: जननी जन्मभूमिष्च स्वर्गादपि गरियसि (sanscrito, Madre e Madrepatria sono più grandi del cielo)
 Nicaragua: En Dios Confiamos (spagnolo, In Dio confidiamo)
 Niger: Fraternité, Travail, Progrès (francese, Fraternità, Lavoro, Progresso)
 Nigeria: Unity and Faith, Peace and Progress (inglese, Unità e Fede, Pace e Progresso)
 Norvegia: Alt for Norge (norvegese, Tutto per la Norvegia) (motto reale) ed Enige og troe, indtil Dovre falder (norvegese, Uniti e leali fino a quando crollino le montagne di Dovre)
 Nuova Zelanda: nessuno, in passato Onward (inglese, Avanti dritto)


== O ==
 Impero Ottomano: دولت ابد مدت (turco, Lo Stato Eterno)


== P ==

 Paesi Bassi: Je maintiendrai (francese, Io manterrò)
 Pakistan: ايمان، اتحاد، نظم (urdu, Fede, Unità, Disciplina)
 Panama: Pro mundi beneficio (latino, Per il bene del mondo)
 Papua Nuova Guinea: Unity in Diversity (inglese, Unità nella Diversità)
 Paraguay: Paz y justicia (spagnolo, Pace e giustizia)
 Polonia: Bóg, Honor, Ojczyzna (polacco, Dio, Onore, Patria) (non ufficiale)
 Portogallo: Esta é a Ditosa Pátria Minha Amada (portoghese, Questo è la Benedetta Patria Mia Amata)
 Regno del Portogallo: Vis unita maior nunc et semper (latino, La forza unita è maggiore, ora e sempre)


== R ==
 Romania: Deşteaptă-te, române! (romeno, Destati, Romania!)
in passato: Nihil Sine Deo (latino, Niente senza Dio)
in precedenza: Toţi în unu (romeno, Tutti in uno).

 Ruanda: Ubumwe, Umurimo, Gukunda Igihugu (kinyarwanda, Unità, Lavoro, Patriottismo)
 Impero russo: С нами Бог (russo, Con noi Dio)


== S ==
 Repubblica Democratica Araba Sahrawi: حرية ديمقراطية وحدة Ḥurrīya Dīmuqrāṭīya Waḥda (arabo, Libertà, Democrazia, Unità)
 Saint Kitts e Nevis: Country Above Self (inglese, La Patria Sopra l'Individuo)
 Saint Vincent e Grenadine: Pax et justitia (latino, Pace e giustizia)
: To lead is to serve (inglese, Guidare è servire)
 Samoa: Fa'avae i le Atua Samoa (samoano, Dio sia il Fondamento di Samoa)
 Samoa Americane: Samoa, Muamua Le Atua (samoano, Samoa, lascia che Dio sia il Primo)
 San Marino: Libertas (latino, Libertà)
 Sant'Elena, Ascensione e Tristan da Cunha: Loyal and unshakeable (inglese, Leale e inagitabile)
 Santa Lucia: The land, the people, the light (inglese, La terra, il popolo, la luce)
 Scozia: In My Defens God Me Defend (inglese, In Mia Difesa Dio Mi Difenda) e Nemo me impune lacessit (latino, Nessuno mi aggredisce impunemente)
 Senegal: Un peuple, un but, une foi (francese, Un popoli, un fine, una fede)
 Serbia: Само Слога Србина Спасава / Samo Sloga Srbina Spasava (serbo, Solo l'Unità Salva i Serbi)
 Regno di Serbia: С Вером у Бога - за Краља и Отаџбину / S Verom u Boga - za Kralja i Otadžbinu (serbo Con fede in Dio - per il Re e per la Patria)

 Seychelles: Finis coronat opus (latino, La fine corona l'opera)
 Sicilia: An.Tu.Do. «ANimus TUus DOminus» (latino, il coraggio è il tuo signore).
 Sierra Leone: Unity, freedom, justice (inglese, Unità, libertà, giustizia)
 Singapore: Majulah Singapura (malay, Avanti Singapore)
 Siria: وحدة ، حرية ، اشتراكية (Waḥdah, Ḥurrīyah, Ishtirākīyah) (arabo, Unità, Libertà, Socialismo)
 Slovacchia: Verní sebe, svorne napred! (slovacco, Fedeli a sé stessi, concordi avanti!)
 Spagna: Plus Ultra (latino, Al di là)In passato: Una, grande y libre (spagnolo, Una, grande e libera)

 Stati Uniti: In God We Trust (inglese, Confidiamo in Dio) (ufficiale); E pluribus unum (latino, Da molti una cosa sola) (de facto)
Stati Confederati d'America: Deo Vindice (latino, Con Dio vendicatore)

 Sudafrica: !ke e: /xarra //ke (ǀxam, Unità nella Diversità)In passato: Ex Unitate Vires (latino, Forza dall'Unità)

 Sudan: النصر لنا An-Naṣr Linā (arabo, La Vittoria è nostra)
 Suriname: Justitia, pietas, fides (latino, Giustizia, pietà, fede)
 Svezia: För Sverige - i tiden (svedese, Per la Svezia - Nei tempi) (motto reale)
 Svizzera: Unus pro omnibus, omnes pro uno (latino, Uno per tutti, tutti per uno) (non ufficiale)
 Swaziland: Siyinqaba (swati, Siamo la fortezza)


== T ==
 Tanzania: Uhuru na Umoja (swahili, Libertà e Unità)
 Territorio antartico britannico: Research and Discovery (inglese, Ricerca e Scoperta)
 Territorio britannico dell'Oceano Indiano: In tutela nostra Limuria (latino, Limuria ci Protegge)
 Thailandia
1873-1910 : शब्बेसम् सम्घभुतनम् समग्घि भुद्धि सधिक (Sabbesamฺ samฺghabhūtānamฺ samagghī vuḍḍhi sadhikā) (pāli Unità porta agli uniti successo e prosperità)
dopo il 1910 : ชาติ ศาสนา พระมหากษัตริย์ (Chat, Satsana, Phra Mahakasat) (thai, Nazione, Religioni, Re) (non ufficiale)

 Timor Est: Honra, pátria e povo (portoghese, Onore, patria e popolo)
 Togo: Travail, Liberté, Patrie (francese, Lavoro, Libertà, Patria)
 Tonga: Ko e ʻOtua mo Tonga ko hoku tofiʻa (tongano, Dio e Tonga sono la mia eredità)
 Trinidad e Tobago: Together we aspire, together we achieve (inglese, Insieme aspiriamo, insieme conseguiamo)
 Tristan da Cunha: Our faith is our strength (inglese, La nostra fede è la nostra forza)
 Tunisia: حرية، نظام، عدالة Ḥurrīyah, Niẓām,ʿAdālah (arabo, Libertà, Ordine, Giustizia)
 Turchia: Egemenlik kayıtsız şartsız milletindir. (turco, La sovranità risiede incondizionatamente nella nazione)
e Yurtta sulh, cihanda sulh. (turco, Pace in patria, pace nel mondo.) Ne mutlu Türküm diyene! (turco, Che felicità dire, sono Turco!)
 Turks e Caicos: One people, one nation, one destiny (inglese, Un popolo, una nazione, un destino)
 Tuvalu: Tuvalu mo te Atua (tuvaluano, Tuvalu per l'Onnipotente)


== U ==
 Ucraina: Воля, Злагода, Добро (Volja, Zlahoda, Dobro) (ucraino, Libertà, Consenso, Bontà)
 Uganda: For God and My Country (inglese, Per Dio e per il Mio Paese)
 Ungheria: in passato Cum Deo pro Patria et Libertate (latino, Con Dio per la Patria e la Libertà)
 URSS: Пролетарии всех стран, соединяйтесь! (Proletarii vsech stran, soedinjajtes) (russo, Proletari di tutto il Mondo, unitevi!)
 Uruguay: Libertad o Muerte (spagnolo, Libertà o Morte)


== V ==
 Vanuatu: Long God yumi stanap (bislama, Stiamo saldi in Dio)
 Venezuela: Dios y Federación (spagnolo, Dio e Federazione)
 Isole Vergini britanniche: Vigilante (latino, Vigilante)
 Vietnam: Ðộc lập, Tự do, Hạnh phúc (vietnamita, Indipendenza, Libertà e Felicità)


== Y ==
 Yemen: Allāh, al-Waṭan, al-Thawra (arabo, Dio, Patria, Rivoluzione)
 Repubblica Democratica Popolare dello Yemen: Jumhūrīya al-Yaman ad-Dīmuqrāṭīyah ash-Sha'bīyah (arabo, Repubblica democratica popolare dello Yemen)


== Z ==
 Zambia: One Zambia, One country (inglese, Uno Zambia, Un Paese)
 Zimbabwe: Unity, Freedom, Work (inglese, Unità, Libertà, Lavoro)


== Note ==