Jody et le Faon (The Yearling) est un film américain réalisé par Clarence Brown, sorti en 1946 et basé sur le roman Jody et le Faon (The Yearling) écrit en 1946 par Marjorie Kinnan Rawlings.


== Synopsis ==
Jody est un jeune garçon vivant avec ses parents dans une région rurale des États-Unis. Un jour, alors qu'il chasse avec son père, ce dernier tue une biche accompagnée de son petit. Désireux de recueillir le faon orphelin, Jody arrive à convaincre ses parents, particulièrement sa mère au tempérament difficile. Mais au fil des mois, l'animal devient de plus en plus incontrôlable et détruit les cultures de la ferme. Jody doit alors se rendre à l'évidence et prendre une décision douloureuse.


== Fiche technique ==
Titre : Jody et le Faon
Titre original : The Yearling
Réalisation : Clarence Brown
Scénario : Paul Osborn d'après le roman Jody et le Faon (The Yearling) de Marjorie Kinnan Rawlings (1946)
Production : Sidney Franklin
Société de production : MGM
Musique : Herbert Stothart
Photographie : Arthur E. Arling, Charles Rosher et Leonard Smith
Montage : Harold F. Kress
Direction artistique : Cedric Gibbons et Paul Groesse
Décors : Edwin B. Willis
Costumes : Valles et Irene
Pays d'origine : États-Unis
Langue : anglais
Format : Couleur (Technicolor) - Son : Mono (Western Electric Sound System)
Genre : Drame
Durée : 128 minutes
Date de sortie : 18 décembre 1946 première Los Angeles (USA)


== Distribution ==
Gregory Peck (V.F : Maurice Dorleac) : Ezra 'Penny' Baxter
Jane Wyman : Orry Baxter
Claude Jarman Jr. : Jody
Chill Wills : Buck Forrester
Clem Bevans : Pa Forrester
Margaret Wycherly : Ma Forrester
Henry Travers : M. Boyles
Forrest Tucker : Lem Forrester
Donn Gift : Fodderwing
Arthur Hohl (non crédité) : Arch Forrester


== Liens externes ==
(en) Jody et le Faon sur l’Internet Movie Database

 Portail du cinéma américain
 Portail des années 1940