Le Fils de Rambow (Son of Rambow) est une comédie franco-germano-britannique de Garth Jennings sortie en 2008.


== Synopsis ==
1982. Will Proudfoot est un jeune garçon élevé dans une communauté religieuse très stricte : il n'a le droit ni de regarder la télévision, ni d'aller au cinéma. Mais un jour, son copain Lee Carter lui montre une version piratée du film Rambo. Subjugués par le film, Will et Lee décident de réaliser leur remake des aventures de John Rambo. Leur version fait un tabac auprès de leurs camarades. Mais c'est sans compter Didier Revol, un correspondant français dont la venue va semer le trouble...


== Fiche technique ==
Titre : Le Fils de Rambow
Titre original : Son of Rambow
Réalisation : Garth Jennings
Scénario : Garth Jennings
Direction artistique : Robyn Paiba
Décors : Joel Collins
Costumes : Harriet Cawley
Photographie : Jess Hall
Montage : Dominic Leung
Musique : Joby Talbot
Distribution  :  Optimum Releasing
Budget : 4,5 millions £
Pays d'origine : France, Allemagne, Royaume-Uni
Langue : français, anglais
Format : Couleur • 2.35:1 • 35mm • SDDS • DTS • Dolby Digital
Genre : Comédie
Durée : 96 minutes
Date de sortie : 2008


== Distribution ==
Neil Dudgeon : Joshua
Bill Milner : Will Proudfoot
Jessica Hynes : Mary Proudfoot
Anna Wing : Grand-mère
Will Poulter : Lee Carter
Ed Westwick : Lawrence Carter
Tallulah Evans : Jess Proudfoot
Émilie Chesnais : le professeur de français
Paul Ritter : le professeur de géographie
Finola McMahon : Gail Graham
Rachel Mureatroyd : Marie Plante
Taylor Richardson : David Smart
Peter Robinson : Lucas Dupont
Charlie Thrift : Duncan Miller
Jules Sitruk : Didier Revol
James Clarke : Shaun
Eric Sykes : Frank
Adam Godley : Brethren Leader
Asa Butterfield : Brethren Boy
Edgar Wright : le professeur de métallurgie
Sylvester Stallone : John Rambo (à la télévision)
Richard Crenna : le colonel Samuel Trautman (à la télévision)


== Sortie ==
En France, le film est sorti directement en DVD. Il est sorti en salles au Royaume-Uni, Allemagne, Israël, Australie, Grèce, Autriche, Pays-Bas, Portugal...
Le film a été présenté dans de nombreux festivals : Festival du film de Sundance, Festival du film de Newport Beach, Festival international du film de Seattle, Festival international du film de Toronto, Festival du film de Glasgow, Festival du film de Floride, Festival du film de Minneapolis, Festival international du film RiverRun, Festival international du film de Locarno, Festival du film d'Athènes, Festival international du film de Helsinki, Festival du film de Zagreb.


== Tournage ==
Le film a été tourné en Angleterre :
dans le comté de Hertfordshire : Berkhamsted, Little Gaddesden
dans le comté de Hampshire : Farnborough
dans le comté de Kent : Sandwich


== Autour du film ==
La femme du réalisateur Garth Jennings joue dans le film le rôle d'une infirmière qui soigne le bras de Will à l'hôpital.


== Notes et références ==


== Annexes ==


=== Articles connexes ===
Saga Rambo
Rambo (film, 1982)


=== Liens externes ===
(en) Le Fils de Rambow sur l’Internet Movie Database
Le Fils de Rambow sur Allociné
Site officiel

 Portail du cinéma